眉をひそめる	まゆをひそめる
歯が立たない	はがたたない
舌を巻く	したをまく
息を殺す	いきをころす
息をのむ	いきをのむ
頬が落ちる	ほおがおちる
首を突っ込む	くびをつっこむ
首をかしげる	くびをかしげる
喉から手が出る	のどからてがでる
肩を並べる	かたをならべる
肩の荷が下りる	かたのにがおりる
心を鬼にする	こころをおににする
心を奪う	こころをうばう
心をつかむ	こころをつかむ
肝を冷やす	きもをひやす
腑に落ちない	ふにおちない
臍を曲げる	へそをまげる
腰が抜ける	こしがぬける
親のすねをかじる	おやのすねをかじる
骨が折れる	ほねがおれる