圧巻	あっかん
王道	おうどう
温故知新	おんこちしん
画竜点睛	がりょうてんせい
完璧	かんぺき
杞憂	きゆう
玉石混淆	ぎょくせきこんこう
呉越同舟	ごえつどうしゅう
国士無双	こくしむそう
五十歩百歩	ごじっぽひゃっぽ
五里霧中	ごりむちゅう
守株	しゅしゅ
四面楚歌	しめんそか
推敲	すいこう
杜撰	ずさん
是是非非	ぜぜひひ
切磋琢磨	せっさたくま
千里眼	せんりがん
太公望	たいこうぼう
蛇足	だそく
単刀直入	たんとうちょくにゅう
朝三暮四	ちょうさんぼし
朝令暮改	ちょうれいぼかい
天衣無縫	てんいむほう
桃源	とうげん
登竜門	とうりゅうもん
白眉	はくび
馬耳東風	ばじとうふう
破天荒	はてんこう
傍若無人	ぼうじゃくぶじん
明鏡止水	めいきょうしすい
矛盾	むじゅん