頭が上がらない	あたまがあがらない
頭が固い	あたまがかたい
頭が切れる	あたまがきれる
頭を捻る	あたまをひねる
頭が高い	ずがたかい
頭を冷やす	あたまをひやす
顔が広い	かおがひろい
顔を洗う	かおをあらう
顔を出す	かおをだす
顔に泥を塗る	かおにどろをぬる
顔向けできない	かおむけできない
合わせる顔がない	あわせるかおがない
目が高い	めがたかい
目から鱗が落ちる	めからうろこがおちる
目と鼻の先	めとはなのさき
目も当てられない	めもあてられない
目を奪われる	めをうばわれる
目を盗む	めをぬすむ
長い目で見る	ながいめでみる
抜け目がない	ぬけめがない