腕が上がる	うでがあがる
腕が立つ	うでがたつ
腕に覚えがある	うでにおぼえがある
腕を振るう	うでをふるう
腕を磨く	うでをみがく
手が空く	てがあく
手がかかる	てがかかる
手がつけられない	てがつけられない
手が早い	てがはやい
手に汗握る	てにあせにぎる
手に負えない	てにおえない
手も足も出ない	てもあしもでない
手を打つ	てをうつ
手を貸す	てをかす
手を差し伸べる	てをさしのべる
手を染める	てをそめる
手を尽くす	てをつくす
手を焼く	てをやく
打つ手がない	うつてがない
手のひらを反す	てのひらをかえす