鼻が利く	はながきく
鼻が高い	はながたかい
鼻であしらう	はなであしらう
鼻にかける	はなにかける
鼻を明かす	はなをあかす
開いた口が塞がらない	あいたくちがふさがらない
口裏を合わせる	くちうらをあわせる
口がうまい	くちがうまい
口が堅い	くちがかたい
口が酸っぱくなる	くちがすっぱくなる
口車に乗る	くちぐるまにのる
口を滑らす	くちをすべらす
口をそろえる	くちをそろえる
口を挟む	くちをはさむ
口を割る	くちをわる
耳が痛い	みみがいたい
耳にたこができる	みみにたこができる
耳を疑う	みみをうたがう
耳を傾ける	みみをかたむける
聞き耳を立てる	ききみみをたてる