胸を借りる	むねをかりる
胸をなでおろす	むねをなでおろす
胸をふくらませる	むねをふくらませる
胸を弾ませる	むねをはずませる
腹が黒い	はらがくろい
腹の虫がおさまらない	はらのむしがおさまらない
腹を抱える	はらをかかえる
腹をくくる	はらをくくる
腹を立てる	はらをたてる
腹を割る	はらをわる
足がつく	あしがつく
足が棒になる	あしがぼうになる
足元にも及ばない	あしもとにもおよばない
足を洗う	あしをあらう
足元を見る	あしもとをみる
足を引っ張る	あしをひっぱる
足を踏み入れる	あしをふみいれる
揚げ足をとる	あげあしをとる
二の足を踏む	にのあしをふむ
脚光を浴びる	きゃっこうをあびる