焼け石に水	やけいしにみず
安物買いの銭失い	やすものがいのぜにうしない
藪から棒	やぶからぼう
藪をつついて蛇を出す	やぶをつついてへびをだす
病は気から	やまいはきから
柳に雪折れなし	やなぎにゆきおれなし
寄らば大樹の陰	よらばたいじゅのかげ
弱り目に祟り目	よわりめにたたりめ
来年の事を言えば鬼が笑う	らいねんのことをいえばおにがわらう
楽あれば苦あり	らくあればくあり
両手に花	りょうてにはな
良薬は口に苦し	りょうやくはくちににがし
類は友を呼ぶ	るいはともをよぶ
礼儀も過ぎれば無礼になる	れいぎもすぎればぶれいになる
ローマは一日にして成らず	ろーまはいちにちにしてならず
論より証拠	ろんよりしょうこ
若い時の苦労は買ってもせよ	わかいときのくろうはかってもせよ
笑う門には福来る	わらうかどにはふくきたる
渡る世間に鬼はない	わたるせけんにおにはない
和を以て貴しとなす	わをもってとうとしとなす