花より団子	はなよりだんご
早起きは三文の徳	はやおきはさんもんのとく
人の噂も七十五日	ひとのうわさもしちじゅうごにち
人の振り見て我が振り直せ	ひとのふりみてわがふりなおせ
火のない所に煙は立たぬ	ひのないところにけむりはたたぬ
瓢箪から駒	ひょうたんからこま
豚に真珠	ぶたにしんじゅ
武士は食わねど高楊枝	ぶしはくわねどたかようじ
仏の顔も三度まで	ほとけのかおもさんどまで
骨折り損のくたびれ儲け	ほねおりぞんのくたびれもうけ
負けるが勝ち	まけるがかち
身から出た錆	みからでたさび
三つ子の魂百まで	みつごのたましいひゃくまで
水に油	みずにあぶら
無理が通れば道理引っ込む	むりがとおればどうりひっこむ
無用の長物	むようのちょうぶつ
目には目を歯には歯を	めにはめをはにははを
目は口ほどに物を言う	めはくちほどにものをいう
餅は餅屋	もちはもちや
桃栗三年柿八年	ももくりさんねんかきはちねん