歳月人を待たず	さいげつひとをまたず
猿も木から落ちる	さるもきからおちる
触らぬ神に祟りなし	さわらぬかみにたたりなし
地獄の沙汰も金次第	じごくのさたもかねしだい
事実は小説よりも奇なり	じじつはしょうせつよりもきなり
親しき中にも礼儀あり	したしきなかにもれいぎあり
失敗は成功のもと	しっぱいはせいこうのもと
死人に口なし	しにんにくちなし
釈迦に説法	しゃかにせっぽう
重箱の隅を楊枝でほじくる	じゅうばこのすみをようじでほじくる
朱に交われば赤くなる	しゅにまじわればあかくなる
知らぬが仏	しらぬがほとけ
好きこそ物の上手なれ	すきこそもののじょうずなれ
雀百まで踊り忘れず	すずめひゃくまでおどりわすれず
捨てる神あれば拾う神あり	すてるかみあればひろうかみあり
背に腹は替えられれぬ	せにはらはかえられぬ
善は急げ	ぜんはいそげ
千里の道も一歩から	せんりのみちもいっぽから
備えあれば憂いなし	そなえあればうれいなし
損して得取れ	そんしてとくとれ