悪銭身に付かず	あくせんみにつかず
頭隠して尻隠さず	あたまかくしてしりかくさず
雨降って地固まる	あめふってじかたまる
石橋を叩いて渡る	いしばしをたたいてわたる
石の上にも三年	いしのうえにもさんねん
急がば回れ	いそがばまわれ
医者の不養生	いしゃのふようじょう
一難去ってまた一難	いちなんさってまたいちなん
一寸の虫にも五分の魂	いっすんのむしにもごぶのたましい
言わぬが花	いわぬがはな
犬も歩けば棒に当たる	いぬもあるけばぼうにあたる
魚心あれば水心	うおごころあればみずごころ
嘘は泥棒の始まり	うそはどろぼうのはじまり
馬の耳に念仏	うまのみみにねんぶつ
海老で鯛を釣る	えびでたいをつる
老いては子に従え	おいてはこにしたがえ
帯に短し襷に長し	おびにみじかしたすきにながし
鬼に金棒	おににかなぼう
鬼の目にも涙	おにのめにもなみだ
溺れる者は藁をも掴む	おぼれるものはわらをもつかむ