情けは人の為ならず	なさけはひとのためならず
長い物には巻かれろ	ながいものにはまかれろ
泣きっ面に蜂	なきっつらにはち
泣く子は育つ	なくこはそだつ
二階から目薬	にかいからめぐすり
逃がした魚は大きい	にがしたさかなはおおきい
憎まれっ子世に憚る	にくまれっこよにはばかる
二兎を追う者は一兎をも得ず	にとをおうものはいっとをもえず
二度あることは三度ある	にどあることはさんどある
糠に釘	ぬかにくぎ
盗人にも三分の理	ぬすびとにもさんぶのり
濡れ手で粟	ぬれてであわ
猫に小判	ねこにこばん
猫の手も借りたい	ねこのてもかりたい
寝耳に水	ねみみにみず
寝る子は育つ	ねるこはそだつ
念には念を入れよ	ねんにはねんをいれよ
能ある鷹は爪を隠す	のうあるたかはつめをかくす
残り物には福がある	のこりものにはふくがある
喉元過ぎれば熱さを忘れる	のどもとすぎればあつさをわすれる