虻	あぶ
水黽	あめんぼ
蟻	あり
井守	いもり
蛆	うじ
蚊	か
蛾	が
蚕	かいこ
蛙	かえる
蜉蝣	かげろう
蝸牛	かたつむり
甲虫	かぶとむし
蟷螂	かまきり
天牛	かみきりむし
螽斯	きりぎりす
蜘蛛	くも
鍬形虫	くわがたむし
蟋蟀	こおろぎ
虱	しらみ
蝉	せみ
蝶	ちょう
天道虫	てんとうむし
蜻蛉	とんぼ
蛞蝓	なめくじ
蚤	のみ
蠅	はえ
蜂	はち
飛蝗	ばった
孑孑	ぼうふら
蛍	ほたる
蚯蚓	みみず
百足	むかで
守宮/家守	やもり