アメリカ合衆国	あめりかがっしゅうこく
アンティグアバーブーダ	あんてぃぐあばーぶーだ
エルサルバドル	えるさるばどる
カナダ	かなだ
キューバ	きゅーば
グアテマラ	ぐあてまら
グレナダ	ぐらなだ
コスタリカ	こすたりか
ジャマイカ	じゃまいか
セントクリストファー・ネイビス	せんとくりすとふぁー・ねいびす
セントビンセント・グレナディーン	せんとびんせんと・ぐれなでぃーん
セントルシア	せんとるしあ
ドミニカ共和国	どみにかきょうわこく
ドミニカ国	どみにかこく
トリニダード・トバゴ	とりにだーどどばご
ニカラグア	にからぐあ
ハイチ	はいち
パナマ	ぱなま
バハマ	ばはま
バルバドス	ばるばどす
ベリーズ	べりーず
ホンジュラス	ほんじゅらす
メキシコ	めきしこ